...###..........
..##.#.########.
.##..###......#.
##........#..##.
#...@..#..#..#..
###..###..#..#..
..#..#.......#..
.##.##.#.#####..
.#......##......
.#.....##.......
.#######........
................